11111
10001
1PC01
10001
11111
