11111
10E01
1PCE1
10001
11111
