11111
10001
10CE1
10001
11111
