11111
10001
1PCE1
10P01
11111
