11111
10001
1P0E1
10001
11111
