11111
10001
11PCE1
10001
11111
