11111
10001
1PCE11
10001
11111
