11111
10001
0PCE1
10001
11111
