11111
10001
1PCE0
10001
11111
