11111
10001
1PCE1
10001
11011
