111111
1P00C1
101111
1010E1
111111
