111111
1P00E1
101111
101CC1
111111
