111111
1P00E1
101111
1C10C1
111111
