11111
10R01
1PCE1
10001
11111
