111111111111111111111111111111111111111111111111111111111111111111111
1E10C00C0P00000000000000000000000000000000000000000000000000000000001
100000000000000000000000000000000000000000000000000000000000000000001
111111111111111111111111111111111111111111111111111111111111111111111